NO ./img/bluestone.xpm
SO ./img/colorstone.xpm
WE ./img/greystone.xpm
EA ./img/redbrick.xpm



F 176,129,18
C 124,203,249


        11111111111111111111111111111111111111111111111111111111111111111111111111111
        13000000031100000000000010000000000001000000000000100000000000010000000000001
        11110000011100030000000010003000000000000300000000000030000000010003000000001
        1000000000000000000W000000000000000001000000000000100000000000000000000000001
1111111110110000011100030000000010003000000001000300000000100030000000010003000000001
1000000000110000011100001222111111111111111111111111111111111111111111111111111111111
11110111111111011100000010001
11110111111111011101010010001
11000000110101011100000010001
10000000000000001100000010001
13000000000000001101010010001
1100300111010101111101111000111
11110111 1110101 101111010001
11111111 1111111 111111111111