NO ./img/bluestone.xpm
SO ./img/colorstone.xpm
WE ./img/greystone.xpm
EA ./img/redbrick.xpm



F 176,129,18
C 124,203,249


        1111111111111111111111111
        1300000003110000000000001
        1111000001110003000000001
        1000000000000000000W00001
111111111011000001110003000000001
1000000000110000011100001222111111111111111111111111111111
11110111111111011100000010000000000000000000000000000000001
11110111111111011101010010000000000000000000000000000000001
11000000110101011100000010000000000000000000000000000000001
1000000000000000110000001000111111111111111111111111111111
13000000000000001101010010001
1100300111010101111101111000111
11110111 1110101 101111010001
11111111 1111111 111111111111