NO ./img/bluestone.xpm
SO ./img/colorstone.xpm
WE ./img/greystone.xpm
EA ./img/redbrick.xpm



F 176,129, 18
C 124 , 203 , 249


        1111111111111111111111111
        1300000003110000000000001
        1111000001110003000000001
        1000000000000000000W00001
111111111011000001110003000000001
100000000011000001110000122211111
11110111111111011100000010001
11110111111111011101010010001
11000000110101011100000010001
10000000000000001100000010001
13000000000000001101010010001
1100300111010101111101111000111
11110111 1110101 101111010001
11111111 1111111 111111111111