NO ./texture/blue_wall.xpm
SO ./texture/steel_wall.xpm
WE ./texture/grey_wall.xpm
EA ./texture/red_brick_wall.xpm



F 176,129,18
C 124,203,249


        1111111111111111111111111
        1000000000110000000000001
        1111000001110001000000001
        1000000000220400000W00001
111111111011000001110001000000001
10000000001100000111000010001111111111111111111111111111111
11110111111111011100000010000000000000000000000000000000001
11110111111111011101010010000000000000000000000000000000001
11000000110101011100040010000000000000000000000000000000001
10000000000000001100000010001111111111111111111111111111111
10000000000000001101010010001
1100000111010101111101111000111
11110111 1110101 101111010001
11111111 1111111 111111111111
