NO ./texture/blue_wall.xpm
SO ./texture/steel_wall.xpm
WE ./texture/grey_wall.xpm
EA ./texture/red_brick_wall.xpm



F 176,129,18
C 124,203,249


        11111111111111111111111111111111111111
        10000000001100000000000010000000000001
        11110000011100400000000010000000000001
        1000000000000000004W000000000000000001
1111111110110000011100000000000410000000000001
1000000000110000011100001222111111111111111111
11110111111111011100000010001
11110111111111011101010010001
11000000110101011100000010001
10000000000000001100000010001
10000000000000001100000010001
10000000000000001101010010001
1100000111010101111101111000111
11110111 1110101 101111010001
11111111 1111111 111111111111
