NO ./texture/north.xpm
SO ./texture/south.xpm
WE ./texture/west.xpm
EA ./texture/east.xpm




F 168, 167, 94
C 38, 71, 92


11111111111
14440000001
10000000001
10004444001
10000000001
10000E00001
10000000001
10000000001
10000000001
10000000001
11111111111
